6 19
6 4
6 15
*******************
***#*****########**
*######**#****#****
***#**#**#**######*
*###**####****#****
***#**********#****